10 10
# # # # # # # # # #
# e x x # x # # x #
# # x # # x # # x #
# x x # x x # # x #
# x # # x # # # # #
# x # x x x x x x #
# x # # # # # # # #
# x x x # x x x s #
# # # # # # # # # #
# # # # # # # # # #